1111111111111111111111111111111111
10000000000E000C00000C000000000001
10E0010100100000101001000000010101
1000010010101010101001000000010101
100000000C00C00000000000P0000C0001
1111111111111111111111111111111111